TILES
1 1 1 1 1 1 1 1 1 1 1 1 1 1 1
1 0 0 0 0 0 0 0 0 0 0 0 0 0 1
1 0 0 0 0 0 0 0 0 0 0 0 0 0 1
1 0 0 1 1 1 1 1 1 1 1 1 0 0 1
1 0 0 1 0 0 0 0 0 0 0 0 0 0 1
1 0 0 1 0 0 0 0 0 0 0 0 0 0 1
1 0 0 1 0 0 1 1 1 1 1 1 0 0 1
1 0 0 1 0 0 1 0 0 0 0 1 0 0 1
1 0 0 1 0 0 1 0 0 0 0 1 0 0 1
1 0 0 1 0 0 1 1 1 0 0 1 0 0 1
1 0 0 1 0 0 0 0 0 0 0 1 0 0 1
1 0 0 1 0 0 0 0 0 0 0 1 0 0 1
1 0 0 1 1 1 1 1 1 1 1 1 0 0 1
1 0 0 0 0 0 0 0 0 0 0 0 0 0 1
1 0 0 0 0 0 0 0 0 0 0 0 0 0 1
1 1 1 1 1 1 1 1 1 1 1 1 1 1 1
PLAYER
1.100456,13.85464
EXIT
7.133181,7.400304
SLOW ENEMY
12.586,1.406393 1.484018,1.555556 12.52207,13.55936
SLOW ENEMY PATROL
12.586,1.406393;1.4414,1.512938;1.270928,13.36073;12.84171,13.12633 1.484018,1.555556;1.143074,13.5312;12.71385,13.31811;12.43683,1.214612 12.52207,13.55936;12.54338,1.406393;1.398782,1.576865;1.249619,13.59513
FAST ENEMY
8.133181,7.506849
FAST ENEMY PATROL
|
PUSH MINE
4.462366,10.51613 4.462366,4.516129 9.424731,10.49462
