TILES
1 1 1 1 1 1 1 1 1 1 1 1 1 1 1
1 0 0 0 0 0 0 0 0 0 0 0 0 0 1
1 0 0 0 0 0 0 0 0 0 0 0 0 0 1
1 0 0 1 1 1 1 1 1 1 1 1 0 0 1
1 0 0 1 0 0 0 0 0 0 0 0 0 0 1
1 0 0 1 0 0 0 0 0 0 0 0 0 0 1
1 0 0 1 0 0 1 1 1 1 1 1 0 0 1
1 0 0 1 0 0 1 0 0 0 0 1 0 0 1
1 0 0 1 0 0 1 0 0 0 0 1 0 0 1
1 0 0 1 0 0 1 1 1 0 0 1 0 0 1
1 0 0 1 0 0 0 0 0 0 0 1 0 0 1
1 0 0 1 0 0 0 0 0 0 0 1 0 0 1
1 0 0 1 1 1 1 1 1 1 1 1 0 0 1
1 0 0 0 0 0 0 0 0 0 0 0 0 0 1
1 0 0 0 0 0 0 0 0 0 0 0 0 0 1
1 1 1 1 1 1 1 1 1 1 1 1 1 1 1
PLAYER
1.100456,13.85464
EXIT
7.133181,7.400304
SLOW ENEMY
1.484018,1.555556 12.52207,13.55936
SLOW ENEMY PATROL
1.484018,1.555556;1.143074,13.5312;12.71385,13.31811;12.43683,1.214612 12.52207,13.55936;12.54338,1.406393;1.398782,1.576865;1.249619,13.59513
FAST ENEMY
8.133181,7.506849
FAST ENEMY PATROL
|
SLOW MINE
4.232877,4.260274 4.232877,10.80213 10.45161,4.5
HELMET
9.462366,10.47849 1.865591,13.0914 12.5,1.752688
 
